22
75
000000000000000000001111100000000000000000000000000000000000000000000000000
000000000000000000001111100000000000000000000000000000000000000000000000000
000000000000000000001111100000000000000000000000000000000000000000000000000
000000000000000000001111100000000000000000000000000000000000000000000000000
000000000000000000001111100000000000000000000000000000000000000000000000000
000000000000000000001111100000000000000000000000000000000000000000000000000
000000000000000000001111100000000000000000000000000000000000000000000000000
000000000000000000001111100000000000000000000000000000000000000000000000000
000000000000000000001111100000000000000000000000000000000000000000000000000
000000000000000000001111100000000000000000000000000000000000000000000000000
000000000000000000001111100000000000000000000000000000000000000000000000000
000000000000000000001111100000000000000000000000000000000000000000000000000
000000000000000000001111100000000000000000000000000000000000000000000000000
000000000000000000001111100000000000000000000000000000000000000000000000000
000000000000000000000000000000000000000000000111111111111111111111111111111
000000000000000000000000000000000000000000000111111111111111111111111111111
000000000000000000000000000000000000000000000111111111111111111111111111111
000000000000000000000000000000000000000000000111111111111111111111111111111
111111111100000111111111111111111111111111111111111111111111111111111111111
111111111100000111111111111111111111111111111111111111111111111111111111111
111111111100000111111111111111111111111111111111111111111111111111111111111
111111111100000111111111111111111111111111111111111111111111111111111111111