22
75
000000000000000000000000000000000000000000000000001111100000000000000000000
000000000000000000000000000000000000000000000000001111100000000000000000000
000000000000000000000000000000000000000000000000001111100000000000000000000
000000000000000000000000000000000000000000000000001111100000000000000000000
000000000000000000000000000000000000000000000000001111100000000000000000000
000000000000000000000000000000000000000000000000001111100000000000000000000
000000000000000000000000000000000000000000000000001111100000000000000000000
000000000000000000000000000000000000000000000000001111100000000000000000000
000000000000000000000000000000000000000000000000001111100000000000000000000
000000000000000000000000000000000000000000000000001111100000000000000000000
000000000000000000000000000000000000000000000000001111100000000000000000000
000000000000000000000000000000000000000000000000001111100000000000000000000
000000000000000000000000000000000000000000000000001111100000000000000000000
000000000000000000000000000000000000000000000000001111100000000000000000000
111111111111111111111111111111000000000000000000000000000000000000000000000
111111111111111111111111111111000000000000000000000000000000000000000000000
111111111111111111111111111111000000000000000000000000000000000000000000000
111111111111111111111111111111000000000000000000000000000000000000000000000
111111111111111111111111111111111111111111111111111111111111000001111111111
111111111111111111111111111111111111111111111111111111111111000001111111111
111111111111111111111111111111111111111111111111111111111111000001111111111
111111111111111111111111111111111111111111111111111111111111000001111111111