22
75
000000000000000000000000000000000000000000000000000000000000000000000000000
000000000000000000000000000000000000000000000000000000000000000000000000000
000000000000000000000000000000000000000000000000000000000000000000000000000
000000000000000000000000000000000000000000000000000000000000000000000000000
000000000000000000000000000000000000000000000000000000000000000000000000000
000000000000000000000000000000000000000000000000000000000000000000000000000
000000000000000000000000000000000000000000000000000000000000000000000000000
000000000000000000000000000000000000000000000000000000000000000000000000000
000000000000000000000000000000000000000000000000000000000000000000000000000
000000000000000000000000000000000000000000000000000000000000000000000000000
000000000000000000000000000000000000000000000000000000000000000000000000000
000000000000000000000000000000000000000000000000000000000000000000000000000
000000000000000000000000000000000000000000000000000000000000000000000000000
000000000000000000000000000000000000000000000000000000000000000000000000000
000000000000000000000000000000000000000000000000000000000000000000000000000
000000000000000000000000000000211111111111111000000000000000000000000000000
000000000000000000000000000000211111111111111000000000000000000000000000000
111111111111111000000000000000211111111111111000000000000000111111111111111
111111111111111111110000011111111111111111111111110000011111111111111111111
111111111111111111110000011111111111111111111111110000011111111111111111111
111111111111111111110000011111111111111111111111110000011111111111111111111
222222222222222222222222222222222222222222222222222222222222222222222222222